110022244222001111002224422200111100222442220011
011022244222011001102224422201100110222442220110
001002222220010000100222222001000010022222200100
001100000000110000110000000011000011000000001100
000111000011100000011100001110000001110000111000
220001000010002222000100001000222200010000100022
222001111110022222200111111002222220011111100222
222000011000022222200000000002222220000110000222
222000011000022222200000000002222220000110000222
222001111110022222200111111002222220011111100222
220001000010002222000100001000222200010000100022
000111000011100000011100001110000001110000111000
001100000000110000110000000011000011000000001100
001002222220010000100222222001000010022222200100
011022244222011001102224422201100110222442220110
110022244222001111002224422200111100222442220011
110022244222001111002224422200111100222442220011
011022244222011001102224422201100110222442220110
001002222220010000100222222001000010022222200100
001100000000110000110000000011000011000000001100
000111000011100000011100001110000001110000111000
220001000010002222000100001000222200010000100022
222001111110022222200111111002222220011111100222
222000011000022222200000000002222220000110000222
222000011000022222200000000002222220000110000222
222001111110022222200111111002222220011111100222
220001000010002222000100001000222200010000100022
000111000011100000011100001110000001110000111000
001100000000110000110000000011000011000000001100
001002222220010000100222222001000010022222200100
011022244222011001102224422201100110222442220110
110022244222001111002224422200111100222442220011